++++++++++++++++++++
+                  +
+                  +
+                  +
+                  +
+                  +
+                  +
+                  +
+                  +
+                  +
+                  +
+                  +
+       *     *   !+
+@  **   *     *  ++
++++++++++++++++++++
