++++++++++++++++++++
+                  +
+                  +
+                  +
+                  +
+                  +
+                  +
+                  +
+                  +
+                  +
+ + @*             +
+ + ++             +
+ +   ++++         +
+!++        **     +
++++++++++++++++++++
