++++++++++++++++++++
+                  +
+                  +
+                  +
+                  +
+                  +
+                  +
+!                 +
++                 +
++                 +
++++               +
++++               +
++++++        *    +
++++++    @  *+*   +
++++++++++++++++++++
