++++++++++++++++++++
+                  +
+                  +
+                  +
+                  +
+                  +
+                  +
+                  +
+                  +
++                 +
! *                +
++++  **           +
++++ ++++*         +
++++       *    @ *+
++++++++++++++++++++
