++++++++++++++++++++
+                  +
+                  +
+                  +
+                  +
+                  +
+              +   +
+              +   +
+       ***    +  !+
+     ++++++++++++++
+    +             +
+   +              +
+  +               +
+@+                +
++++++++++++++++++++
