++++++++++++++++++++
+                  +
+                  +
+                  +
+                  +
+                  +
+                  +
+           *      +
+          * *     +
+     ++++++ +++++++
+    +             +
+   +            ! +
+  +             + +
+@+              + +
++++++++++++++++++++
