++++++++++++++++++++
+                  +
+                  +
+        @         +
+        *         +
+       ***        +
+      **!**       +
+     *****!*      +
+    ***!*****     +
+   *******!***    +
+    +   +   +     +
+!       +         +
+++      +         +
+        +         +
++++++++++++++++++++
