++++++++++++++++++++
+                  +
+                  +
+                  +
+                  +
+                  +
+                  +
+                  +
+                  +
+     +            +
+    +++           +
+@ *+++!*          +
++++               +
+         **       +
++++++++++++++++++++
