++++++++++++++++++++
+                  +
+                  +
+                  +
+                  +
+                  +
+             @*   +
+             +++  +
+          *       +
+          +++     +
+!      *          +
+++     +++        +
+++                +
+++                +
++++++++++++++++++++
