++++++++++++++++++++
+                  +
+                  +
+                  +
+                  +
+                  +
+                  +
+                  +
+                  +
+                  +
+        *        !+
+ *   *           ++
+        +*       ++
+     @           ++
++++++++++++++++++++
