++++++++++++++++++++
+                  +
+                  +
+                  +
+                  +
+                  +
+                  +
+                  +
+                  !
+                  +
+     *            +
+    **            +
+   ***            +
+@ ****            +
++++++++++++++++++++
