++++++++++++++++++++
+                  +
+                  +
+                  +
+                  +
+                  +
+                  +
+                  +
+                  +
+!                 +
++                 +
++  +          *   +
++  ++        *** @+
++  +++++   **++++++
++++++++++++++++++++
