++++++++++++++++++++
+                  +
+                  +
+                  +
+                  +
+                  +
+                  +
+                  +
+                  +
+                  +
+                  +
+                  +
+  ++      +++     +
+ !+++  *    +*  @ +
++++++++++++++++++++
