++++++++++++++++++++
+                  +
+                  +
+                  +
+ !                +
+++++              +
+                  +
+                  +
+       *********  +
+    +++++++++++++++
+*                 +
+++++              +
+   +              +
+!  +   *   @  * * +
++++++++++++++++++++
