++++++++++++++++++++
+                  +
+                  +
+                  +
+@** !             +
++++ +             +
+    +         ** *+
+    ++++++   ++++++
+            +     +
+           ++     +
+                  +
+                  +
+         +  **    +
+**      +++++++   +
++++++++++++++++++++
