++++++++++++++++++++
+                  +
+!                 +
++                 +
+                  +
+***               +
+****              +
++++++++++++++     +
+                  +
+                  +
+                  +
+*                 +
+***   + *****     +
+****  +********@  +
++++++++++++++++++++
