+++++++++++++++
+             +
+             +
+             +
+             +
+             +
+             +
+             +
+  +          +
+  !        @ +
+++++++++++++++