+++++++++++++++
+             +
+             +
+             +
+             +
+             +
+             +
+             +
++            +
+!          @ +
+++++++++++++++