+++++++++++++++
+             +
+             +
+             +
+             +
+             +
+             +
+             +
+             +
+!          @ +
+++++++++++++++