++++++++++++++++++++
+         +        +
+         ++       +
+    ++++++++++    +
+   +@         +   +
+  +        **  +  +
+ +             !+ +
+ +           ++++ +
+ +          +   + +
+ +         +    + +
+  +       +    +  +
+   +*         +   +
+    ++++++++++    +
+                  +
++++++++++++++++++++
