++++++++++++++++++++
+                  +
+                  +
+                  +
+                  +
+                  +
+                  +
+                  +
+                  +
+                  +
+                  +
!           *   *@ +
++   *  +   +   ++++
++  **  ++  ++++++++
++++++++++++++++++++