+++++++++++++++
+             +
+             +
+             +
+* *         !+
+* *          +
++++++++++*  ++
+           *++
+ *++++++++++++
+            @+
+++++++++++++++