+++++++++++++++
+             +
+             +
+             +
+             +
+             +
+ + @*        +
+ + ++        +
+ +   ++      +
+!++       ** +
+++++++++++++++