+++++++++++++++
+             +
+             +
+!            +
++            +
++            +
+++           +
+++           +
++++       *  +
++++   @  *+* +
+++++++++++++++