+++++++++++++++
+             +
+             +
+!            +
++            +
++            +
++++          +
++++          +
++++++     *  +
++++++ @  *+* +
+++++++++++++++