++++++++++++++++++++
+                  +
+                  +
+                  +
+                  +
+                  +
+                  +
+                  +
+                  +
+                  +
+       !          +
+       +          +
+                  +
+ **+      @   *   +
++++++++++++++++++++