+++++++++++++++
+             +
+             +
+             +
+             +
+      +      +
+     !+      +
+     ++      +
+             +
+ **+     @  *+
+++++++++++++++