+++++++++++++++
+             +
+             +
+         @ * +
+        ++++++
+             +
+            !+
+        ++++++
+             +
+  **         +
+++++++++++++++