+++++++++++++++
+!            +
+++           +
+   *         +
+*  ++        +
++++  +       +
+      +      +
+        +    +
+       +     +
+  @      ****+
+++++++++++++++