+++++++++++++++
+             +
+           @*+
+           +++
+        *    +
+        +++  +
+!    *       +
+++   +++     +
+++           +
+++          ++
+++++++++++++++