++++++++++++++++++++
+!                 +
+        *   *     +
++    ** +  *+     +
+ *  ++++  +++     +
+++       +        +
+  ++              +
+    + +           +
+       ++  *      +
+   ++++   ++ *    +
+ +      ++  ++ ** +
+  +*  ++       ++ +
+   ++         +   +
+@          *      +
++++++++++++++++++++