++++++++++++++++++++
+                  +
+                  +
+                  +
+                  +
+                  +
+                  +
+                  +
+* *              !+
+* *               +
+++++++++++++++*  ++
+                *++
+ *+++++++++++++++++
+                 @+
++++++++++++++++++++
