++++++++++++++++++++
+                  +
+                  +
+                  +
+                  +
+                  +
+                  +
+              @ * +
+             ++++++
+                  +
+                 !+
+             ++++++
+                  +
+  **              +
++++++++++++++++++++
