********************
*                  *
*                  *
*                  *
*                  *
*                  *
*                  *
*                  *
*                  *
*                  *
*                  *
*                 **
*   +  +  *      + *
*@+   *+++*     + !*
********************