++++++++++++++++++++
+                  +
+                  +
+                  +
+                  +
+                  +
+                  +
+                  +
+                  +
+!                 +
++              ***+
+ @           ++++++
+ +                +
+ +    *    ++     +
++++++++++++++++++++
