++++++++++++++++++++
+                  +
+                  +
+                  +
+                  +
+                  +
+                  +
+@*   *   *   *   !+
+++  ++  ++  ++  +++
+                  +
+  ++  ++  ++  ++  +
+                  +
+                  +
+                  +
++++++++++++++++++++
