++++++++++++++++++++
+                  +
+      @           +
+      *    *      +
+      *    *      +
+      *    *      +
+      *    *      +
+    *        *    +
+     *      *     +
+      ******      +
+                  +
+        !         +
+        +         +
+        +         +
++++++++++++++++++++
