+++++++++++++++
+             +
+             +
+             +
+             +
+             +
+             +
+             +
+      +      +
+ !    +  * @ +
+++++++++++++++