++++++++++++++++++++
+@                 +
++++  *            +
+   +++  *         +
+      +++  *      +
+         +++      +
+                  +
+                  +
+                  +
+                  +
+                  +
!                  +
+                  +
+                  +
++++++++++++++++++++
