++++++++++++++++++++
+                  +
+@                 +
+++                +
+ +                +
+ +  **            +
+ +++++++          +
+                  +
+            *     +
+        +++++++++++
+                  +
+                 !+
+                  +
+                  +
++++++++++++++++++++
