++++++++++++++++++++
+                  +
+                  +
+                  +
+                  +
+                  +
+                  +
+                  +
+                  +
+                  +
+                  +
+  +++++++++++    ++
+  +++++         +++
+! +++++**@*    ++++
++++++++++++++++++++