++++++++++++++++++++
+@                 +
++                 +
+ +                +
+  +               +
+   +              +
+    +             +
+!     **          +
+     ++++         +
+ +                +
+  +               +
+   +              +
+    +             +
+     +   ** *   * +
++++++++++++++++++++
