++++++++++++++++++++
+                  +
+                  +
+                  +
+                  +
+                  +
+                  +
+                  +
+                  +
+     *            +
+                  +
+     *         *+ +
+     +++        + +
+        @*     +! +
++++++++++++++++++++