+++++++++++++++
+             +
+             +
+             +
+             +
+             +
+  *          +
+ ********** !+
+            @+
+++++++++++++++