+++++++++++++++
+             +
+             +
+             +
+             +
+             +
+             +
+             +
+ ++    +++   +
+!+++ *   +* @+
+++++++++++++++