++++++++++++++++++++
+                  +
+!                !+
+*                *+
+ *              * +
+  *            *  +
+   *          *   +
+    *        *    +
+     *      *     +
+                  +
+       *  *       +
+*    +++**+++    *+
+++              +++
++++    @**     ++++
++++++++++++++++++++ 