++++++++++++++++++++
+                  +
+                  +
+                  +
+                  +
+!                 +
+++                +
+   *              +
+*  ++             +
++++  +            +
+      +           +
+        +         +
+       +          +
+  @      ****     +
++++++++++++++++++++
