++++++++++++++++++++
+                  +
+                  +
+                  +
+                  +
+                  +
+                  +
+                  +
+@                !+
++                ++
+++              +++
++++            ++++
+++++          +++++
+++++*         +++++
++++++++++++++++++++