++++++++++++++++++++
+                  +
+                  +
+@  *              +
+++++ ++++++       +
+     +            +
+   ++  ++         +
+  *   *           +
+++++++++++++  +   +
+       !    ++    +
+       +       * *+
+        ++++++ ++++
+                  +
+                  +
++++++++++++++++++++
