++++++++++++++++++++
+                  +
+                  +
+      ***         +
+    ++++++++      +
+                  +
+@***              +
+++++              +
+                  +
+                  +
+!                 +
+                  +
+                  +
+                  +
++++++++++++++++++++
