++++++++++++++++++++
+                  +
+                  +
+                  +
+                  +
+                  +
+                  +
+                  +
+                  +
+     +++++        +
+    +++++++       +
+       +          +
+       +  @       +
+ !     +  *** *** +
++++++++++++++++++++
