++++++++++++++++++++
+                  +
+@                 +
++                 +
+  *               +
+ ++               +
+                  +
+   ++             +
+      ++++        +
+                  +
+     +    +++     +
+                  +
+             !    +
+                  +
++++++++++++++++++++