++++++++++++++++++++
+                  +
+                  +
+                  +
+                  +
+                  +
+                  +
+                  +
+                  +
+                  +
+                  +
+                  +
+*             +   +
+**+*+  +  @   +!  +
++++++++++++++++++++