+++++++++++++++
+             +
+  +  +++ +   +
+  +  + + +@  +
+  ++ +++ ++  +
++            +
! *           +
++++  **      +
++++ ++++*    +
++++        **+
+++++++++++++++