+++++++++++++++
+             +
+             +
+             +
+             +
++            +
! *           +
++++  **      +
++++ ++++*    +
++++       @**+
+++++++++++++++