++++++++++++++++++++
+                  +
+                  +
+                  +
+                  +
+                  +
+                  +
+                  +
+                  +
+                  +
+                  +
+                  +
+     +    ++      +
+*   @+*   ++      !
++++++++++++++++++++
