+++++++++++++++
+             +
+             +
+             +
+             +
+             +
!             +
++            +
++        *   +
++        ** @+
+++++++++++++++