+++++++++++++++
+             +
+             +
+             +
+             +
+             +
+            !+
+            ++
+*    +      ++
+** @ +  *  +++
+++++++++++++++