++++++++++++++++++++
+                  +
+                  +
+                  +
+                  +
+                  +
+                  +
+                  +
+                  +
+                  +
+                 !+
+                 ++
+ *      +        ++
+ **  @  +   *   +++
++++++++++++++++++++