+++++++++++++++
+             +
+             +
+             +
+             +
+             +
+             +
+             +
+ ********** !+
+            @+
+++++++++++++++