++++++++++++++++++++
+                  +
+                  +
+                  +
+                  +
+                  +
+                  +
+                  +
+                  +
+                  +
!                  +
++                 +
++       *         +
++       **     @  +
++++++++++++++++++++
