+++++++++++++++
+             +
+             +
+             +
+             +
+             +
+             +
+             +
+   +   ++    +
+* @+*  ++   !+
+++++++++++++++