++++++++++++++++++++++++
+                      +
!                      +
++       +             +
++    *   *   @        +
++++++++++++++++++++++++