++++++++++++++++++++++++
+                      +
!                      +
++                     +
++        *   @        +
++++++++++++++++++++++++