+++++++++++++++
+             +
+             +
+             +
+             +
+             +
+             +
!        *  *@+
++  * +  +  +++
++ ** ++ ++++++
+++++++++++++++